Somei	Soi
Somer	Sor
Somed	Sod
Sometn	Sot
Sometd	Sot
Somem	Som
Someo	Soo
Somdi	Soi
Somdr	Sor
Somdd	Sod
Somdt	Sot
Somdm	Som
Somdo	Soo
Sommi	Soi
Sommr	Sor
Sommd	Sod
Sommt	Sot
Sommm	Som
Sommo	Soo
Sozei	Soi
Sozer	Sor
Sozed	Sod
Sozet	Sot
Sozem	Som
Sozeo	Soo
Sozdi	Soi
Sozdr	Sor
Sozdd	Sod
Sozdt	Sot
Sozdm	Som
Sozdo	Soo
Sozmi	Soi
Sozmr	Sor
Sozmd	Sod
Sozmt	Sot
Sozmm	Som
Sozmo	Soo
Sosei	Soi
Soser	Sor
Sosed	Sod
Soset	Sot
Sosem	Som
Soseo	Soo
Sosdi	Soi
Sosdr	Sor
Sosdd	Sod
Sosdt	Sot
Sosdm	Som
Sosdo	Soo
Sosmi	Soi
Sosmr	Sor
Sosmd	Sod
Sosmt	Sot
Sosmm	Som
Sosmo	Soo
Slmei	Sli
Slmer	Slr
Slmed	Sld
Slmetn	Slt
Slmetd	Slt
Slmem	Slm
Slmeo	Slo
Slmdi	Sli
Slmdr	Slr
Slmdd	Sld
Slmdt	Slt
Slmdm	Slm
Slmdo	Slo
Slmmi	Sli
Slmmr	Slr
Slmmd	Sld
Slmmt	Slt
Slmmm	Slm
Slmmo	Slo
Slzei	Sli
Slzer	Slr
Slzed	Sld
Slzet	Slt
Slzem	Slm
Slzeo	Slo
Slzdi	Sli
Slzdr	Slr
Slzdd	Sld
Slzdt	Slt
Slzdm	Slm
Slzdo	Slo
Slzmi	Sli
Slzmr	Slr
Slzmd	Sld
Slzmt	Slt
Slzmm	Slm
Slzmo	Slo
Slsei	Sli
Slser	Slr
Slsed	Sld
Slset	Slt
Slsem	Slm
Slseo	Slo
Slsmi	Sli
Slsmr	Slr
Slsmd	Sld
Slsmt	Slt
Slsmm	Slm
Slsmo	Slo
Ggdn	Ggn
Ggdm	Ggm
Ggdd-em	Ggd
Ggdd-ez	Ggd
Ggdd-es	Ggd
Ggdd-mm	Ggd
Ggdd-mz	Ggd
Ggdd-ms	Ggd
Ggdd-dm	Ggd
Ggdd-dz	Ggd
Ggdd-ds	Ggd
Ggdspe	Ggsp
Ggdspm	Ggsp
Ggdspd	Ggsp
Ggdsde	Ggsd
Ggdsdm	Ggsd
Ggdsdd	Ggsd
Ggdste	Ggst
Ggdstm	Ggst
Ggdstd	Ggst
Ggdvpm	Ggv
Ggdvpd	Ggv
Ggdvde	Ggv
Ggdvdm	Ggv
Ggdvdd	Ggv
Ggnn	Ggn
Ggnm	Ggm
Ggnd-em	Ggd
Ggnd-ez	Ggd
Ggnd-es	Ggd
Ggnd-mm	Ggd
Ggnd-mz	Ggd
Ggnd-ms	Ggd
Ggnd-dm	Ggd
Ggnd-dz	Ggd
Ggnd-ds	Ggd
Ggnspe	Ggsp
Ggnspe-n	Ggsp
Ggnspe-d	Ggspd
Ggnspm	Ggsp
Ggnspm-n	Ggsp
Ggnspm-d	Ggspd
Ggnspd	Ggsp
Ggnspd-n	Ggsp
Ggnspd-d	Ggspd
Ggnsde	Ggsd
Ggnsde-n	Ggsd
Ggnsde-d	Ggsdd
Ggnsdm	Ggsd
Ggnsdm-n	Ggsd
Ggnsdm-d	Ggsdd
Ggnsdd	Ggsd
Ggnsdd-n	Ggsd
Ggnsdd-d	Ggsdd
Ggnste	Ggst
Ggnste-n	Ggst
Ggnste-d	Ggstd
Ggnstm	Ggst
Ggnstm-n	Ggst
Ggnstm-d	Ggstd
Ggnstd	Ggst
Ggnstd-n	Ggst
Ggnstd-d	Ggstd
Ggnvpm	Ggv
Ggnvpd	Ggv
Ggnvde	Ggv
Ggnvdm	Ggv
Ggnvdd	Ggv
Ggvn	Ggn
Ggvm	Ggm
Ggvd-em	Ggd
Ggvd-ez	Ggd
Ggvd-es	Ggd
Ggvd-mm	Ggd
Ggvd-mz	Ggd
Ggvd-ms	Ggd
Ggvd-dm	Ggd
Ggvd-dz	Ggd
Ggvd-ds	Ggd
Ggvspe	Ggsp
Ggvspm	Ggsp
Ggvspd	Ggsp
Ggvspdz	Ggsp
Ggvsde	Ggsd
Ggvsdm	Ggsd
Ggvsdd	Ggsd
Ggvste	Ggst
Ggvstm	Ggst
Ggvstd	Ggst
Ggvppe	Ggsp
Ggvppm	Ggsp
Ggvppd	Ggsp
Ggvpde	Ggsd
Ggvpdm	Ggsd
Ggvpdd	Ggsd
Ggvpte	Ggst
Ggvptm	Ggst
Ggvptd	Ggst
Ggvvpm	Ggv
Ggvvpd	Ggv
Ggvvde	Ggv
Ggvvdm	Ggv
Ggvvdd	Ggv
Gp-n	Gpn
Gp-m	Gpn
Gp-d-em	Gpd
Gp-d-ez	Gpd
Gp-d-es	Gpd
Gp-d-mm	Gpd
Gp-d-mz	Gpd
Gp-d-ms	Gpd
Gp-d-dm	Gpd
Gp-d-dz	Gpd
Gp-d-ds	Gpd
Gp-spe-n	Gpsp
Gp-spe-d	Gpspd
Gp-spm-n	Gpsp
Gp-spmzd	Gpspd
Gp-spm-d	Gpspd
Gp-spd-n	Gpsp
Gp-spd-d	Gpspd
Gp-spdzn	Gpsp
Gp-sde-n	Gpsd
Gp-sde-d	Gpsdd
Gp-sdm-n	Gpsd
Gp-sdm-d	Gpsdd
Gp-sdd-n	Gpsd
Gp-sdd-d	Gpsdd
Gp-ste-n	Gpst
Gp-ste-d	Gpstd
Gp-stm-n	Gpst
Gp-stm-d	Gpstd
Gp-std-n	Gpst
Gp-std-d	Gpstd
Gp-ppe-n	Gppp
Gp-ppe-d	Gppp
Gp-ppm-n	Gppp
Gp-ppm-d	Gppp
Gp-ppd	Gppp
Gp-ppd-n	Gppp
Gp-ppd-d	Gppp
Gp-pde-n	Gppd
Gp-pde-d	Gppd
Gp-pdm-n	Gppd
Gp-pdd-n	Gppd
Gp-pte-n	Gppt
Gp-pte-d	Gppt
Gp-ptm-n	Gppt
Gp-ptm-d	Gppt
Gp-ptd-n	Gppt
Gp-g	Gpg
Gp-g---d	Gpg
Gp-vpm	Gpv
Gp-vpd	Gpv
Gp-vde	Gpv
Gp-vdm	Gpv
Gp-vdd	Gpv
Ppnmein	Ppi
Ppnmeid	Ppi
Ppnmer	Ppr
Ppnmed	Ppd
Ppnmet	Ppt
Ppnmetn	Ppt
Ppnmetd	Ppt
Ppnmem	Ppm
Ppnmeo	Ppo
Ppnmdi	Ppi
Ppnmdr	Ppr
Ppnmdd	Ppd
Ppnmdt	Ppt
Ppnmdm	Ppm
Ppnmdo	Ppo
Ppnmmi	Ppi
Ppnmmr	Ppr
Ppnmmd	Ppd
Ppnmmt	Ppt
Ppnmmm	Ppm
Ppnmmo	Ppo
Ppnzei	Ppi
Ppnzer	Ppr
Ppnzed	Ppd
Ppnzet	Ppt
Ppnzem	Ppm
Ppnzeo	Ppo
Ppnzdi	Ppi
Ppnzdr	Ppr
Ppnzdd	Ppd
Ppnzdt	Ppt
Ppnzdm	Ppm
Ppnzdo	Ppo
Ppnzmi	Ppi
Ppnzmr	Ppr
Ppnzmd	Ppd
Ppnzmt	Ppt
Ppnzmm	Ppm
Ppnzmo	Ppo
Ppnsei	Ppi
Ppnser	Ppr
Ppnsed	Ppd
Ppnset	Ppt
Ppnsem	Ppm
Ppnseo	Ppo
Ppnsdi	Ppi
Ppnsdr	Ppr
Ppnsdd	Ppd
Ppnsdt	Ppt
Ppnsdm	Ppm
Ppnsdo	Ppo
Ppnsmi	Ppi
Ppnsmr	Ppr
Ppnsmd	Ppd
Ppnsmt	Ppt
Ppnsmm	Ppm
Ppnsmo	Ppo
Pppmeid	Ppi
Pppmer	Ppr
Pppmed	Ppd
Pppmet	Ppt
Pppmetd	Ppt
Pppmem	Ppm
Pppmeo	Ppo
Pppmdi	Ppi
Pppmdr	Ppr
Pppmdd	Ppd
Pppmdt	Ppt
Pppmdm	Ppm
Pppmdo	Ppo
Pppmmi	Ppi
Pppmmr	Ppr
Pppmmd	Ppd
Pppmmt	Ppt
Pppmmm	Ppm
Pppmmo	Ppo
Pppzei	Ppi
Pppzer	Ppr
Pppzed	Ppd
Pppzet	Ppt
Pppzem	Ppm
Pppzeo	Ppo
Pppzdi	Ppi
Pppzdr	Ppr
Pppzdd	Ppd
Pppzdt	Ppt
Pppzdm	Ppm
Pppzdo	Ppo
Pppzmi	Ppi
Pppzmr	Ppr
Pppzmd	Ppd
Pppzmt	Ppt
Pppzmm	Ppm
Pppzmo	Ppo
Pppsei	Ppi
Pppser	Ppr
Pppsed	Ppd
Pppset	Ppt
Pppsem	Ppm
Pppseo	Ppo
Pppsdi	Ppi
Pppsdr	Ppr
Pppsdd	Ppd
Pppsdt	Ppt
Pppsdm	Ppm
Pppsdo	Ppo
Pppsmi	Ppi
Pppsmr	Ppr
Pppsmd	Ppd
Pppsmt	Ppt
Pppsmm	Ppm
Pppsmo	Ppo
Ppsmeid	Ppi
Ppsmer	Ppr
Ppsmed	Ppd
Ppsmet	Ppt
Ppsmetd	Ppt
Ppsmem	Ppm
Ppsmeo	Ppo
Ppsmdi	Ppi
Ppsmdr	Ppr
Ppsmdd	Ppd
Ppsmdt	Ppt
Ppsmdm	Ppm
Ppsmdo	Ppo
Ppsmmi	Ppi
Ppsmmr	Ppr
Ppsmmd	Ppd
Ppsmmt	Ppt
Ppsmmm	Ppm
Ppsmmo	Ppo
Ppszei	Ppi
Ppszer	Ppr
Ppszed	Ppd
Ppszet	Ppt
Ppszem	Ppm
Ppszeo	Ppo
Ppszdi	Ppi
Ppszdr	Ppr
Ppszdd	Ppd
Ppszdt	Ppt
Ppszdm	Ppm
Ppszdo	Ppo
Ppszmi	Ppi
Ppszmr	Ppr
Ppszmd	Ppd
Ppszmt	Ppt
Ppszmm	Ppm
Ppszmo	Ppo
Ppssei	Ppi
Ppsser	Ppr
Ppssed	Ppd
Ppsset	Ppt
Ppssem	Ppm
Ppsseo	Ppo
Ppssdi	Ppi
Ppssdr	Ppr
Ppssdd	Ppd
Ppssdt	Ppt
Ppssdm	Ppm
Ppssdo	Ppo
Ppssmi	Ppi
Ppssmr	Ppr
Ppssmd	Ppd
Ppssmt	Ppt
Ppssmm	Ppm
Ppssmo	Ppo
Psnmein	Ppi
Psnmer	Ppr
Psnmed	Ppd
Psnmet	Ppt
Psnmetn	Ppt
Psnmem	Ppm
Psnmeo	Ppo
Psnmdi	Ppi
Psnmdr	Ppr
Psnmdd	Ppd
Psnmdt	Ppt
Psnmdm	Ppm
Psnmdo	Ppo
Psnmmi	Ppi
Psnmmr	Ppr
Psnmmd	Ppd
Psnmmt	Ppt
Psnmmm	Ppm
Psnmmo	Ppo
Psnzei	Ppi
Psnzer	Ppr
Psnzed	Ppd
Psnzet	Ppt
Psnzem	Ppm
Psnzeo	Ppo
Psnzdi	Ppi
Psnzdr	Ppr
Psnzdd	Ppd
Psnzdt	Ppt
Psnzdm	Ppm
Psnzdo	Ppo
Psnzmi	Ppi
Psnzmr	Ppr
Psnzmd	Ppd
Psnzmt	Ppt
Psnzmm	Ppm
Psnzmo	Ppo
Psnsei	Ppi
Psnser	Ppr
Psnsed	Ppd
Psnset	Ppt
Psnsem	Ppm
Psnseo	Ppo
Psnsdi	Ppi
Psnsdr	Ppr
Psnsdd	Ppd
Psnsdt	Ppt
Psnsdm	Ppm
Psnsdo	Ppo
Psnsmi	Ppi
Psnsmr	Ppr
Psnsmd	Ppd
Psnsmt	Ppt
Psnsmm	Ppm
Psnsmo	Ppo
Pdnmein	Pdi
Pdnmeid	Pdi
Pdnmer	Pdr
Pdnmed	Pdd
Pdnmet	Pdt
Pdnmetn	Pdt
Pdnmetd	Pdt
Pdnmem	Pdm
Pdnmeo	Pdo
Pdnmdi	Pdi
Pdnmdr	Pdr
Pdnmdd	Pdd
Pdnmdt	Pdt
Pdnmdm	Pdm
Pdnmdo	Pdo
Pdnmmi	Pdi
Pdnmmr	Pdr
Pdnmmd	Pdd
Pdnmmt	Pdt
Pdnmmm	Pdm
Pdnmmo	Pdo
Pdnzei	Pdi
Pdnzer	Pdr
Pdnzed	Pdd
Pdnzet	Pdt
Pdnzem	Pdm
Pdnzeo	Pdo
Pdnzdi	Pdi
Pdnzdr	Pdr
Pdnzdd	Pdd
Pdnzdt	Pdt
Pdnzdm	Pdm
Pdnzdo	Pdo
Pdnzmi	Pdi
Pdnzmr	Pdr
Pdnzmd	Pdd
Pdnzmt	Pdt
Pdnzmm	Pdm
Pdnzmo	Pdo
Pdnsei	Pdi
Pdnser	Pdr
Pdnsed	Pdd
Pdnset	Pdt
Pdnsem	Pdm
Pdnseo	Pdo
Pdnsdi	Pdi
Pdnsdr	Pdr
Pdnsdd	Pdd
Pdnsdt	Pdt
Pdnsdm	Pdm
Pdnsdo	Pdo
Pdnsmi	Pdi
Pdnsmr	Pdr
Pdnsmd	Pdd
Pdnsmt	Pdt
Pdnsmm	Pdm
Pdnsmo	Pdo
Rsn	R
Rsr	R
Rss	R
Rd	R
Zop-ei	Zo
Zop-er	Zo
Zop-er--k	Zo
Zop-ed	Zo
Zop-ed--k	Zo
Zop-et	Zo
Zop-et--k	Zo
Zop-et--z	Zo
Zop-em	Zo
Zop-eo	Zo
Zop-dr	Zo
Zop-dd	Zo
Zop-dt	Zo
Zop-dm	Zo
Zop-do	Zo
Zop-mr	Zo
Zop-md	Zo
Zop-mt	Zo
Zop-mm	Zo
Zop-mo	Zo
Zopmdi	Zo
Zopmmi	Zo
Zopzdi	Zo
Zopzmi	Zo
Zopsdi	Zo
Zopsmi	Zo
Zod-ei	Zo
Zod-er	Zo
Zod-er--k	Zo
Zod-ed	Zo
Zod-ed--k	Zo
Zod-et	Zo
Zod-et--k	Zo
Zod-et--z	Zo
Zod-em	Zo
Zod-eo	Zo
Zod-dr	Zo
Zod-dd	Zo
Zod-dt	Zo
Zod-dm	Zo
Zod-do	Zo
Zod-mr	Zo
Zod-md	Zo
Zod-mt	Zo
Zod-mm	Zo
Zod-mo	Zo
Zodmdi	Zo
Zodmmi	Zo
Zodzdi	Zo
Zodzmi	Zo
Zodsdi	Zo
Zodsmi	Zo
Zotmei	Zo
Zotmer	Zo
Zotmer--k	Zo
Zotmed	Zo
Zotmed--k	Zo
Zotmet	Zo
Zotmet--k	Zo
Zotmet--z	Zo
Zotmem	Zo
Zotmeo	Zo
Zotmdi	Zo
Zotmdr	Zo
Zotmdr--k	Zo
Zotmdd	Zo
Zotmdd--k	Zo
Zotmdt	Zo
Zotmdt--k	Zo
Zotmdt--z	Zo
Zotmdm	Zo
Zotmdo	Zo
Zotmmi	Zo
Zotmmr	Zo
Zotmmr--k	Zo
Zotmmd	Zo
Zotmmd--k	Zo
Zotmmt	Zo
Zotmmt--k	Zo
Zotmmt--z	Zo
Zotmmm	Zo
Zotmmo	Zo
Zotzei	Zo
Zotzer	Zo
Zotzer--k	Zo
Zotzed	Zo
Zotzed--k	Zo
Zotzet	Zo
Zotzet--k	Zo
Zotzet--z	Zo
Zotzem	Zo
Zotzeo	Zo
Zotzdi	Zo
Zotzdr	Zo
Zotzdr--k	Zo
Zotzdd	Zo
Zotzdd--k	Zo
Zotzdt	Zo
Zotzdt--k	Zo
Zotzdt--z	Zo
Zotzdm	Zo
Zotzdo	Zo
Zotzmi	Zo
Zotzmr	Zo
Zotzmr--k	Zo
Zotzmd	Zo
Zotzmd--k	Zo
Zotzmt	Zo
Zotzmt--k	Zo
Zotzmt--z	Zo
Zotzmm	Zo
Zotzmo	Zo
Zotsei	Zo
Zotser	Zo
Zotser--k	Zo
Zotsed	Zo
Zotsed--k	Zo
Zotset	Zo
Zotset--k	Zo
Zotset--z	Zo
Zotsem	Zo
Zotseo	Zo
Zotsdi	Zo
Zotsdr	Zo
Zotsdr--k	Zo
Zotsdd	Zo
Zotsdd--k	Zo
Zotsdt	Zo
Zotsdt--k	Zo
Zotsdt--z	Zo
Zotsdm	Zo
Zotsdo	Zo
Zotsmi	Zo
Zotsmr	Zo
Zotsmr--k	Zo
Zotsmd	Zo
Zotsmd--k	Zo
Zotsmt	Zo
Zotsmt--k	Zo
Zotsmt--z	Zo
Zotsmm	Zo
Zotsmo	Zo
Zspmeie	Zs
Zspmeid	Zs
Zspmeim	Zs
Zspmere	Zs
Zspmerd	Zs
Zspmerm	Zs
Zspmede	Zs
Zspmedd	Zs
Zspmedm	Zs
Zspmete	Zs
Zspmetd	Zs
Zspmetm	Zs
Zspmeme	Zs
Zspmemd	Zs
Zspmemm	Zs
Zspmeoe	Zs
Zspmeod	Zs
Zspmeom	Zs
Zspmdie	Zs
Zspmdid	Zs
Zspmdim	Zs
Zspmdre	Zs
Zspmdrd	Zs
Zspmdrm	Zs
Zspmdde	Zs
Zspmddd	Zs
Zspmddm	Zs
Zspmdte	Zs
Zspmdtd	Zs
Zspmdtm	Zs
Zspmdme	Zs
Zspmdmd	Zs
Zspmdmm	Zs
Zspmdoe	Zs
Zspmdod	Zs
Zspmdom	Zs
Zspmmie	Zs
Zspmmid	Zs
Zspmmim	Zs
Zspmmre	Zs
Zspmmrd	Zs
Zspmmrm	Zs
Zspmmde	Zs
Zspmmdd	Zs
Zspmmdm	Zs
Zspmmte	Zs
Zspmmtd	Zs
Zspmmtm	Zs
Zspmmme	Zs
Zspmmmd	Zs
Zspmmmm	Zs
Zspmmoe	Zs
Zspmmod	Zs
Zspmmom	Zs
Zspzeie	Zs
Zspzeid	Zs
Zspzeim	Zs
Zspzere	Zs
Zspzerd	Zs
Zspzerm	Zs
Zspzede	Zs
Zspzedd	Zs
Zspzedm	Zs
Zspzete	Zs
Zspzetd	Zs
Zspzetm	Zs
Zspzeme	Zs
Zspzemd	Zs
Zspzemm	Zs
Zspzeoe	Zs
Zspzeod	Zs
Zspzeom	Zs
Zspzdie	Zs
Zspzdid	Zs
Zspzdim	Zs
Zspzdre	Zs
Zspzdrd	Zs
Zspzdrm	Zs
Zspzdde	Zs
Zspzddd	Zs
Zspzddm	Zs
Zspzdte	Zs
Zspzdtd	Zs
Zspzdtm	Zs
Zspzdme	Zs
Zspzdmd	Zs
Zspzdmm	Zs
Zspzdoe	Zs
Zspzdod	Zs
Zspzdom	Zs
Zspzmie	Zs
Zspzmid	Zs
Zspzmim	Zs
Zspzmre	Zs
Zspzmrd	Zs
Zspzmrm	Zs
Zspzmde	Zs
Zspzmdd	Zs
Zspzmdm	Zs
Zspzmte	Zs
Zspzmtd	Zs
Zspzmtm	Zs
Zspzmme	Zs
Zspzmmd	Zs
Zspzmmm	Zs
Zspzmoe	Zs
Zspzmod	Zs
Zspzmom	Zs
Zspseie	Zs
Zspseid	Zs
Zspseim	Zs
Zspsere	Zs
Zspserd	Zs
Zspserm	Zs
Zspsede	Zs
Zspsedd	Zs
Zspsedm	Zs
Zspsete	Zs
Zspsetd	Zs
Zspsetm	Zs
Zspseme	Zs
Zspsemd	Zs
Zspsemm	Zs
Zspseoe	Zs
Zspseod	Zs
Zspseom	Zs
Zspsdie	Zs
Zspsdid	Zs
Zspsdim	Zs
Zspsdre	Zs
Zspsdrd	Zs
Zspsdrm	Zs
Zspsdde	Zs
Zspsddd	Zs
Zspsddm	Zs
Zspsdte	Zs
Zspsdtd	Zs
Zspsdtm	Zs
Zspsdme	Zs
Zspsdmd	Zs
Zspsdmm	Zs
Zspsdoe	Zs
Zspsdod	Zs
Zspsdom	Zs
Zspsmie	Zs
Zspsmid	Zs
Zspsmim	Zs
Zspsmre	Zs
Zspsmrd	Zs
Zspsmrm	Zs
Zspsmde	Zs
Zspsmdd	Zs
Zspsmdm	Zs
Zspsmte	Zs
Zspsmtd	Zs
Zspsmtm	Zs
Zspsmme	Zs
Zspsmmd	Zs
Zspsmmm	Zs
Zspsmoe	Zs
Zspsmod	Zs
Zspsmom	Zs
Zsdmeie	Zs
Zsdmeid	Zs
Zsdmeim	Zs
Zsdmere	Zs
Zsdmerd	Zs
Zsdmerm	Zs
Zsdmede	Zs
Zsdmedd	Zs
Zsdmedm	Zs
Zsdmete	Zs
Zsdmetd	Zs
Zsdmetm	Zs
Zsdmeme	Zs
Zsdmemd	Zs
Zsdmemm	Zs
Zsdmeoe	Zs
Zsdmeod	Zs
Zsdmeom	Zs
Zsdmdie	Zs
Zsdmdid	Zs
Zsdmdim	Zs
Zsdmdre	Zs
Zsdmdrd	Zs
Zsdmdrm	Zs
Zsdmdde	Zs
Zsdmddd	Zs
Zsdmddm	Zs
Zsdmdte	Zs
Zsdmdtd	Zs
Zsdmdtm	Zs
Zsdmdme	Zs
Zsdmdmd	Zs
Zsdmdmm	Zs
Zsdmdoe	Zs
Zsdmdod	Zs
Zsdmdom	Zs
Zsdmmie	Zs
Zsdmmid	Zs
Zsdmmim	Zs
Zsdmmre	Zs
Zsdmmrd	Zs
Zsdmmrm	Zs
Zsdmmde	Zs
Zsdmmdd	Zs
Zsdmmdm	Zs
Zsdmmte	Zs
Zsdmmtd	Zs
Zsdmmtm	Zs
Zsdmmme	Zs
Zsdmmmd	Zs
Zsdmmmm	Zs
Zsdmmoe	Zs
Zsdmmod	Zs
Zsdmmom	Zs
Zsdzeie	Zs
Zsdzeid	Zs
Zsdzeim	Zs
Zsdzere	Zs
Zsdzerd	Zs
Zsdzerm	Zs
Zsdzede	Zs
Zsdzedd	Zs
Zsdzedm	Zs
Zsdzete	Zs
Zsdzetd	Zs
Zsdzetm	Zs
Zsdzeme	Zs
Zsdzemd	Zs
Zsdzemm	Zs
Zsdzeoe	Zs
Zsdzeod	Zs
Zsdzeom	Zs
Zsdzdie	Zs
Zsdzdid	Zs
Zsdzdim	Zs
Zsdzdre	Zs
Zsdzdrd	Zs
Zsdzdrm	Zs
Zsdzdde	Zs
Zsdzddd	Zs
Zsdzddm	Zs
Zsdzdte	Zs
Zsdzdtd	Zs
Zsdzdtm	Zs
Zsdzdme	Zs
Zsdzdmd	Zs
Zsdzdmm	Zs
Zsdzdoe	Zs
Zsdzdod	Zs
Zsdzdom	Zs
Zsdzmie	Zs
Zsdzmid	Zs
Zsdzmim	Zs
Zsdzmre	Zs
Zsdzmrd	Zs
Zsdzmrm	Zs
Zsdzmde	Zs
Zsdzmdd	Zs
Zsdzmdm	Zs
Zsdzmte	Zs
Zsdzmtd	Zs
Zsdzmtm	Zs
Zsdzmme	Zs
Zsdzmmd	Zs
Zsdzmmm	Zs
Zsdzmoe	Zs
Zsdzmod	Zs
Zsdzmom	Zs
Zsdseie	Zs
Zsdseid	Zs
Zsdseim	Zs
Zsdsere	Zs
Zsdserd	Zs
Zsdserm	Zs
Zsdsede	Zs
Zsdsedd	Zs
Zsdsedm	Zs
Zsdsete	Zs
Zsdsetd	Zs
Zsdsetm	Zs
Zsdseme	Zs
Zsdsemd	Zs
Zsdsemm	Zs
Zsdseoe	Zs
Zsdseod	Zs
Zsdseom	Zs
Zsdsdie	Zs
Zsdsdid	Zs
Zsdsdim	Zs
Zsdsdre	Zs
Zsdsdrd	Zs
Zsdsdrm	Zs
Zsdsdde	Zs
Zsdsddd	Zs
Zsdsddm	Zs
Zsdsdte	Zs
Zsdsdtd	Zs
Zsdsdtm	Zs
Zsdsdme	Zs
Zsdsdmd	Zs
Zsdsdmm	Zs
Zsdsdoe	Zs
Zsdsdod	Zs
Zsdsdom	Zs
Zsdsmie	Zs
Zsdsmid	Zs
Zsdsmim	Zs
Zsdsmre	Zs
Zsdsmrd	Zs
Zsdsmrm	Zs
Zsdsmde	Zs
Zsdsmdd	Zs
Zsdsmdm	Zs
Zsdsmte	Zs
Zsdsmtd	Zs
Zsdsmtm	Zs
Zsdsmme	Zs
Zsdsmmd	Zs
Zsdsmmm	Zs
Zsdsmoe	Zs
Zsdsmod	Zs
Zsdsmom	Zs
Zstmeiem	Zs
Zstmeiez	Zs
Zstmeies	Zs
Zstmeid	Zs
Zstmeim	Zs
Zstmerem	Zs
Zstmerez	Zs
Zstmeres	Zs
Zstmerd	Zs
Zstmerm	Zs
Zstmedem	Zs
Zstmedez	Zs
Zstmedes	Zs
Zstmedd	Zs
Zstmedm	Zs
Zstmetem	Zs
Zstmetez	Zs
Zstmetes	Zs
Zstmetd	Zs
Zstmetm	Zs
Zstmemem	Zs
Zstmemez	Zs
Zstmemes	Zs
Zstmemd	Zs
Zstmemm	Zs
Zstmeoem	Zs
Zstmeoez	Zs
Zstmeoes	Zs
Zstmeod	Zs
Zstmeom	Zs
Zstmdiem	Zs
Zstmdiez	Zs
Zstmdies	Zs
Zstmdid	Zs
Zstmdim	Zs
Zstmdrem	Zs
Zstmdrez	Zs
Zstmdres	Zs
Zstmdrd	Zs
Zstmdrm	Zs
Zstmddem	Zs
Zstmddez	Zs
Zstmddes	Zs
Zstmddd	Zs
Zstmddm	Zs
Zstmdtem	Zs
Zstmdtez	Zs
Zstmdtes	Zs
Zstmdtd	Zs
Zstmdtm	Zs
Zstmdmem	Zs
Zstmdmez	Zs
Zstmdmes	Zs
Zstmdmd	Zs
Zstmdmm	Zs
Zstmdoem	Zs
Zstmdoez	Zs
Zstmdoes	Zs
Zstmdod	Zs
Zstmdom	Zs
Zstmmiem	Zs
Zstmmiez	Zs
Zstmmies	Zs
Zstmmid	Zs
Zstmmim	Zs
Zstmmrem	Zs
Zstmmrez	Zs
Zstmmres	Zs
Zstmmrd	Zs
Zstmmrm	Zs
Zstmmdem	Zs
Zstmmdez	Zs
Zstmmdes	Zs
Zstmmdd	Zs
Zstmmdm	Zs
Zstmmtem	Zs
Zstmmtez	Zs
Zstmmtes	Zs
Zstmmtd	Zs
Zstmmtm	Zs
Zstmmmem	Zs
Zstmmmez	Zs
Zstmmmes	Zs
Zstmmmd	Zs
Zstmmmm	Zs
Zstmmoem	Zs
Zstmmoez	Zs
Zstmmoes	Zs
Zstmmod	Zs
Zstmmom	Zs
Zstzeiem	Zs
Zstzeiez	Zs
Zstzeies	Zs
Zstzeid	Zs
Zstzeim	Zs
Zstzerem	Zs
Zstzerez	Zs
Zstzeres	Zs
Zstzerd	Zs
Zstzerm	Zs
Zstzedem	Zs
Zstzedez	Zs
Zstzedes	Zs
Zstzedd	Zs
Zstzedm	Zs
Zstzetem	Zs
Zstzetez	Zs
Zstzetes	Zs
Zstzetd	Zs
Zstzetm	Zs
Zstzemem	Zs
Zstzemez	Zs
Zstzemes	Zs
Zstzemd	Zs
Zstzemm	Zs
Zstzeoem	Zs
Zstzeoez	Zs
Zstzeoes	Zs
Zstzeod	Zs
Zstzeom	Zs
Zstzdiem	Zs
Zstzdiez	Zs
Zstzdies	Zs
Zstzdid	Zs
Zstzdim	Zs
Zstzdrem	Zs
Zstzdrez	Zs
Zstzdres	Zs
Zstzdrd	Zs
Zstzdrm	Zs
Zstzddem	Zs
Zstzddez	Zs
Zstzddes	Zs
Zstzddd	Zs
Zstzddm	Zs
Zstzdtem	Zs
Zstzdtez	Zs
Zstzdtes	Zs
Zstzdtd	Zs
Zstzdtm	Zs
Zstzdmem	Zs
Zstzdmez	Zs
Zstzdmes	Zs
Zstzdmd	Zs
Zstzdmm	Zs
Zstzdoem	Zs
Zstzdoez	Zs
Zstzdoes	Zs
Zstzdod	Zs
Zstzdom	Zs
Zstzmiem	Zs
Zstzmiez	Zs
Zstzmies	Zs
Zstzmid	Zs
Zstzmim	Zs
Zstzmrem	Zs
Zstzmrez	Zs
Zstzmres	Zs
Zstzmrd	Zs
Zstzmrm	Zs
Zstzmdem	Zs
Zstzmdez	Zs
Zstzmdes	Zs
Zstzmdd	Zs
Zstzmdm	Zs
Zstzmtem	Zs
Zstzmtez	Zs
Zstzmtes	Zs
Zstzmtd	Zs
Zstzmtm	Zs
Zstzmmem	Zs
Zstzmmez	Zs
Zstzmmes	Zs
Zstzmmd	Zs
Zstzmmm	Zs
Zstzmoem	Zs
Zstzmoez	Zs
Zstzmoes	Zs
Zstzmod	Zs
Zstzmom	Zs
Zstseiem	Zs
Zstseiez	Zs
Zstseies	Zs
Zstseid	Zs
Zstseim	Zs
Zstserem	Zs
Zstserez	Zs
Zstseres	Zs
Zstserd	Zs
Zstserm	Zs
Zstsedem	Zs
Zstsedez	Zs
Zstsedes	Zs
Zstsedd	Zs
Zstsedm	Zs
Zstsetem	Zs
Zstsetez	Zs
Zstsetes	Zs
Zstsetd	Zs
Zstsetm	Zs
Zstsemem	Zs
Zstsemez	Zs
Zstsemes	Zs
Zstsemd	Zs
Zstsemm	Zs
Zstseoem	Zs
Zstseoez	Zs
Zstseoes	Zs
Zstseod	Zs
Zstseom	Zs
Zstsdiem	Zs
Zstsdiez	Zs
Zstsdies	Zs
Zstsdid	Zs
Zstsdim	Zs
Zstsdrem	Zs
Zstsdrez	Zs
Zstsdres	Zs
Zstsdrd	Zs
Zstsdrm	Zs
Zstsddem	Zs
Zstsddez	Zs
Zstsddes	Zs
Zstsddd	Zs
Zstsddm	Zs
Zstsdtem	Zs
Zstsdtez	Zs
Zstsdtes	Zs
Zstsdtd	Zs
Zstsdtm	Zs
Zstsdmem	Zs
Zstsdmez	Zs
Zstsdmes	Zs
Zstsdmd	Zs
Zstsdmm	Zs
Zstsdoem	Zs
Zstsdoez	Zs
Zstsdoes	Zs
Zstsdod	Zs
Zstsdom	Zs
Zstsmiem	Zs
Zstsmiez	Zs
Zstsmies	Zs
Zstsmid	Zs
Zstsmim	Zs
Zstsmrem	Zs
Zstsmrez	Zs
Zstsmres	Zs
Zstsmrd	Zs
Zstsmrm	Zs
Zstsmdem	Zs
Zstsmdez	Zs
Zstsmdes	Zs
Zstsmdd	Zs
Zstsmdm	Zs
Zstsmtem	Zs
Zstsmtez	Zs
Zstsmtes	Zs
Zstsmtd	Zs
Zstsmtm	Zs
Zstsmmem	Zs
Zstsmmez	Zs
Zstsmmes	Zs
Zstsmmd	Zs
Zstsmmm	Zs
Zstsmoem	Zs
Zstsmoez	Zs
Zstsmoes	Zs
Zstsmod	Zs
Zstsmom	Zs
Zk-mei	Zk
Zk-mer	Zk
Zk-med	Zk
Zk-met	Zk
Zk-mem	Zk
Zk-meo	Zk
Zk-mdi	Zk
Zk-mdr	Zk
Zk-mdd	Zk
Zk-mdt	Zk
Zk-mdm	Zk
Zk-mdo	Zk
Zk-mmi	Zk
Zk-mmr	Zk
Zk-mmd	Zk
Zk-mmt	Zk
Zk-mmm	Zk
Zk-mmo	Zk
Zk-zei	Zk
Zk-zer	Zk
Zk-zed	Zk
Zk-zet	Zk
Zk-zem	Zk
Zk-zeo	Zk
Zk-zdi	Zk
Zk-zdr	Zk
Zk-zdd	Zk
Zk-zdt	Zk
Zk-zdm	Zk
Zk-zdo	Zk
Zk-zmi	Zk
Zk-zmr	Zk
Zk-zmd	Zk
Zk-zmt	Zk
Zk-zmm	Zk
Zk-zmo	Zk
Zk-sei	Zk
Zk-ser	Zk
Zk-sed	Zk
Zk-set	Zk
Zk-sem	Zk
Zk-seo	Zk
Zk-sdi	Zk
Zk-sdr	Zk
Zk-sdd	Zk
Zk-sdt	Zk
Zk-sdm	Zk
Zk-sdo	Zk
Zk-smi	Zk
Zk-smr	Zk
Zk-smd	Zk
Zk-smt	Zk
Zk-smm	Zk
Zk-smo	Zk
Zz	Zz
Zz----em	Zz
Zz-mei	Zz
Zz-mer	Zz
Zz-med	Zz
Zz-met	Zz
Zz-mem	Zz
Zz-meo	Zz
Zz-mdi	Zz
Zz-mdr	Zz
Zz-mdd	Zz
Zz-mdt	Zz
Zz-mdm	Zz
Zz-mdo	Zz
Zz-mmi	Zz
Zz-mmr	Zz
Zz-mmd	Zz
Zz-mmt	Zz
Zz-mmm	Zz
Zz-mmo	Zz
Zz-zei	Zz
Zz-zer	Zz
Zz-zed	Zz
Zz-zet	Zz
Zz-zem	Zz
Zz-zeo	Zz
Zz-zdi	Zz
Zz-zdr	Zz
Zz-zdd	Zz
Zz-zdt	Zz
Zz-zdm	Zz
Zz-zdo	Zz
Zz-zmi	Zz
Zz-zmr	Zz
Zz-zmd	Zz
Zz-zmt	Zz
Zz-zmm	Zz
Zz-zmo	Zz
Zz-sei	Zz
Zz-ser	Zz
Zz-sed	Zz
Zz-set	Zz
Zz-sem	Zz
Zz-seo	Zz
Zz-sdi	Zz
Zz-sdr	Zz
Zz-sdd	Zz
Zz-sdt	Zz
Zz-sdm	Zz
Zz-sdo	Zz
Zz-smi	Zz
Zz-smr	Zz
Zz-smd	Zz
Zz-smt	Zz
Zz-smm	Zz
Zz-smo	Zz
Zp------k	Zp
Zp---r	Zp
Zp---d	Zp
Zp---d--k	Zp
Zp---t	Zp
Zp---t--z	Zp
Zp---m	Zp
Zp---o	Zp
Zp-mei	Zp
Zp-mer	Zp
Zp-med	Zp
Zp-met	Zp
Zp-mem	Zp
Zp-meo	Zp
Zp-mdi	Zp
Zp-mdr	Zp
Zp-mdd	Zp
Zp-mdt	Zp
Zp-mdm	Zp
Zp-mdo	Zp
Zp-mmi	Zp
Zp-mmr	Zp
Zp-mmd	Zp
Zp-mmt	Zp
Zp-mmm	Zp
Zp-mmo	Zp
Zp-zei	Zp
Zp-zer	Zp
Zp-zed	Zp
Zp-zet	Zp
Zp-zem	Zp
Zp-zeo	Zp
Zp-zdi	Zp
Zp-zdr	Zp
Zp-zdd	Zp
Zp-zdt	Zp
Zp-zdm	Zp
Zp-zdo	Zp
Zp-zmi	Zp
Zp-zmr	Zp
Zp-zmd	Zp
Zp-zmt	Zp
Zp-zmm	Zp
Zp-zmo	Zp
Zp-sei	Zp
Zp-ser	Zp
Zp-sed	Zp
Zp-set	Zp
Zp-sem	Zp
Zp-seo	Zp
Zp-sdi	Zp
Zp-sdr	Zp
Zp-sdd	Zp
Zp-sdt	Zp
Zp-sdm	Zp
Zp-sdo	Zp
Zp-smi	Zp
Zp-smr	Zp
Zp-smd	Zp
Zp-smt	Zp
Zp-smm	Zp
Zp-smo	Zp
Zc-mei	Zc
Zc-mer	Zc
Zc-med	Zc
Zc-met	Zc
Zc-mem	Zc
Zc-meo	Zc
Zc-mdi	Zc
Zc-mdr	Zc
Zc-mdd	Zc
Zc-mdt	Zc
Zc-mdm	Zc
Zc-mdo	Zc
Zc-mmi	Zc
Zc-mmr	Zc
Zc-mmd	Zc
Zc-mmt	Zc
Zc-mmm	Zc
Zc-mmo	Zc
Zc-zei	Zc
Zc-zer	Zc
Zc-zed	Zc
Zc-zet	Zc
Zc-zem	Zc
Zc-zeo	Zc
Zc-zdi	Zc
Zc-zdr	Zc
Zc-zdd	Zc
Zc-zdt	Zc
Zc-zdm	Zc
Zc-zdo	Zc
Zc-zmi	Zc
Zc-zmr	Zc
Zc-zmd	Zc
Zc-zmt	Zc
Zc-zmm	Zc
Zc-zmo	Zc
Zc-sei	Zc
Zc-ser	Zc
Zc-sed	Zc
Zc-set	Zc
Zc-sem	Zc
Zc-seo	Zc
Zc-sdi	Zc
Zc-sdr	Zc
Zc-sdd	Zc
Zc-sdt	Zc
Zc-sdm	Zc
Zc-sdo	Zc
Zc-smi	Zc
Zc-smr	Zc
Zc-smd	Zc
Zc-smt	Zc
Zc-smm	Zc
Zc-smo	Zc
Zv----em	Zv
Zv----ez	Zv
Zv----es	Zv
Zv----d	Zv
Zv----m	Zv
Zv-mei	Zv
Zv-mer	Zv
Zv-med	Zv
Zv-met	Zv
Zv-mem	Zv
Zv-meo	Zv
Zv-mdi	Zv
Zv-mdr	Zv
Zv-mdd	Zv
Zv-mdt	Zv
Zv-mdm	Zv
Zv-mdo	Zv
Zv-mmi	Zv
Zv-mmr	Zv
Zv-mmd	Zv
Zv-mmt	Zv
Zv-mmm	Zv
Zv-mmo	Zv
Zv-zei	Zv
Zv-zer	Zv
Zv-zed	Zv
Zv-zet	Zv
Zv-zem	Zv
Zv-zeo	Zv
Zv-zdi	Zv
Zv-zdr	Zv
Zv-zdd	Zv
Zv-zdt	Zv
Zv-zdm	Zv
Zv-zdo	Zv
Zv-zmi	Zv
Zv-zmr	Zv
Zv-zmd	Zv
Zv-zmt	Zv
Zv-zmm	Zv
Zv-zmo	Zv
Zv-sei	Zv
Zv-ser	Zv
Zv-sed	Zv
Zv-set	Zv
Zv-sem	Zv
Zv-seo	Zv
Zv-sdi	Zv
Zv-sdr	Zv
Zv-sdd	Zv
Zv-sdt	Zv
Zv-sdm	Zv
Zv-sdo	Zv
Zv-smi	Zv
Zv-smr	Zv
Zv-smd	Zv
Zv-smt	Zv
Zv-smm	Zv
Zv-smo	Zv
Zn-mei	Zn
Zn-mer	Zn
Zn-med	Zn
Zn-met	Zn
Zn-mem	Zn
Zn-meo	Zn
Zn-mdi	Zn
Zn-mdr	Zn
Zn-mdd	Zn
Zn-mdt	Zn
Zn-mdm	Zn
Zn-mdo	Zn
Zn-mmi	Zn
Zn-mmr	Zn
Zn-mmd	Zn
Zn-mmt	Zn
Zn-mmm	Zn
Zn-mmo	Zn
Zn-zei	Zn
Zn-zer	Zn
Zn-zed	Zn
Zn-zet	Zn
Zn-zem	Zn
Zn-zeo	Zn
Zn-zdi	Zn
Zn-zdr	Zn
Zn-zdd	Zn
Zn-zdt	Zn
Zn-zdm	Zn
Zn-zdo	Zn
Zn-zmi	Zn
Zn-zmr	Zn
Zn-zmd	Zn
Zn-zmt	Zn
Zn-zmm	Zn
Zn-zmo	Zn
Zn-sei	Zn
Zn-ser	Zn
Zn-sed	Zn
Zn-set	Zn
Zn-sem	Zn
Zn-seo	Zn
Zn-sdi	Zn
Zn-sdr	Zn
Zn-sdd	Zn
Zn-sdt	Zn
Zn-sdm	Zn
Zn-sdo	Zn
Zn-smi	Zn
Zn-smr	Zn
Zn-smd	Zn
Zn-smt	Zn
Zn-smm	Zn
Zn-smo	Zn
Zl-mei	Zl
Zl-mer	Zl
Zl-med	Zl
Zl-met	Zl
Zl-mem	Zl
Zl-meo	Zl
Zl-mdi	Zl
Zl-mdr	Zl
Zl-mdd	Zl
Zl-mdt	Zl
Zl-mdm	Zl
Zl-mdo	Zl
Zl-mmi	Zl
Zl-mmr	Zl
Zl-mmd	Zl
Zl-mmt	Zl
Zl-mmm	Zl
Zl-mmo	Zl
Zl-zei	Zl
Zl-zer	Zl
Zl-zed	Zl
Zl-zet	Zl
Zl-zem	Zl
Zl-zeo	Zl
Zl-zdi	Zl
Zl-zdr	Zl
Zl-zdd	Zl
Zl-zdt	Zl
Zl-zdm	Zl
Zl-zdo	Zl
Zl-zmi	Zl
Zl-zmr	Zl
Zl-zmd	Zl
Zl-zmt	Zl
Zl-zmm	Zl
Zl-zmo	Zl
Zl-sei	Zl
Zl-ser	Zl
Zl-sed	Zl
Zl-set	Zl
Zl-sem	Zl
Zl-seo	Zl
Zl-sdi	Zl
Zl-sdr	Zl
Zl-sdd	Zl
Zl-sdt	Zl
Zl-sdm	Zl
Zl-sdo	Zl
Zl-smi	Zl
Zl-smr	Zl
Zl-smd	Zl
Zl-smt	Zl
Zl-smm	Zl
Zl-smo	Zl
Kag	K
Kav	K
Krg	K
Krv	K
Kbg-mi	K
Kbg-mr	K
Kbg-md	K
Kbg-mt	K
Kbg-mm	K
Kbg-mo	K
Kbgmdi	K
Kbgmdr	K
Kbgmdd	K
Kbgmdt	K
Kbgmdm	K
Kbgmdo	K
Kbgmmi	K
Kbgmmr	K
Kbgmmd	K
Kbgmmt	K
Kbgmmm	K
Kbgmmo	K
Kbgzdi	K
Kbgzdr	K
Kbgzdd	K
Kbgzdt	K
Kbgzdm	K
Kbgzdo	K
Kbgzmi	K
Kbgzmr	K
Kbgzmd	K
Kbgzmt	K
Kbgzmm	K
Kbgzmo	K
Kbgsdi	K
Kbgsdr	K
Kbgsdd	K
Kbgsdt	K
Kbgsdm	K
Kbgsdo	K
Kbgsmi	K
Kbgsmr	K
Kbgsmd	K
Kbgsmt	K
Kbgsmm	K
Kbgsmo	K
Kbvmei	K
Kbvmer	K
Kbvmed	K
Kbvmet	K
Kbvmem	K
Kbvmeo	K
Kbvmdi	K
Kbvmdr	K
Kbvmdd	K
Kbvmdt	K
Kbvmdm	K
Kbvmdo	K
Kbvmmi	K
Kbvmmr	K
Kbvmmd	K
Kbvmmt	K
Kbvmmm	K
Kbvmmo	K
Kbvzei	K
Kbvzer	K
Kbvzed	K
Kbvzet	K
Kbvzem	K
Kbvzeo	K
Kbvzdi	K
Kbvzdr	K
Kbvzdd	K
Kbvzdt	K
Kbvzdm	K
Kbvzdo	K
Kbvzmi	K
Kbvzmr	K
Kbvzmd	K
Kbvzmt	K
Kbvzmm	K
Kbvzmo	K
Kbvsei	K
Kbvser	K
Kbvsed	K
Kbvset	K
Kbvsem	K
Kbvseo	K
Kbvsdi	K
Kbvsdr	K
Kbvsdd	K
Kbvsdt	K
Kbvsdm	K
Kbvsdo	K
Kbvsmi	K
Kbvsmr	K
Kbvsmd	K
Kbvsmt	K
Kbvsmm	K
Kbvsmo	K
Kbzmei	K
Kbzmein	K
Kbzmeid	K
Kbzmer	K
Kbzmed	K
Kbzmet	K
Kbzmetn	K
Kbzmetd	K
Kbzmem	K
Kbzmeo	K
Kbzmdi	K
Kbzmdr	K
Kbzmdd	K
Kbzmdt	K
Kbzmdm	K
Kbzmdo	K
Kbzmmi	K
Kbzmmr	K
Kbzmmd	K
Kbzmmt	K
Kbzmmm	K
Kbzmmo	K
Kbzzei	K
Kbzzer	K
Kbzzed	K
Kbzzet	K
Kbzzem	K
Kbzzeo	K
Kbzzdi	K
Kbzzdr	K
Kbzzdd	K
Kbzzdt	K
Kbzzdm	K
Kbzzdo	K
Kbzzmi	K
Kbzzmr	K
Kbzzmd	K
Kbzzmt	K
Kbzzmm	K
Kbzzmo	K
Kbzsei	K
Kbzser	K
Kbzsed	K
Kbzset	K
Kbzsem	K
Kbzseo	K
Kbzsdi	K
Kbzsdr	K
Kbzsdd	K
Kbzsdt	K
Kbzsdm	K
Kbzsdo	K
Kbzsmi	K
Kbzsmr	K
Kbzsmd	K
Kbzsmt	K
Kbzsmm	K
Kbzsmo	K
Kbdmein	K
Kbdmeid	K
Kbdmer	K
Kbdmed	K
Kbdmet	K
Kbdmetn	K
Kbdmetd	K
Kbdmem	K
Kbdmeo	K
Kbdmdi	K
Kbdmdr	K
Kbdmdd	K
Kbdmdt	K
Kbdmdm	K
Kbdmdo	K
Kbdmmi	K
Kbdmmr	K
Kbdmmd	K
Kbdmmt	K
Kbdmmm	K
Kbdmmo	K
Kbdzei	K
Kbdzer	K
Kbdzed	K
Kbdzet	K
Kbdzem	K
Kbdzeo	K
Kbdzdi	K
Kbdzdr	K
Kbdzdd	K
Kbdzdt	K
Kbdzdm	K
Kbdzdo	K
Kbdzmi	K
Kbdzmr	K
Kbdzmd	K
Kbdzmt	K
Kbdzmm	K
Kbdzmo	K
Kbdsei	K
Kbdser	K
Kbdsed	K
Kbdset	K
Kbdsem	K
Kbdseo	K
Kbdsdi	K
Kbdsdr	K
Kbdsdd	K
Kbdsdt	K
Kbdsdm	K
Kbdsdo	K
Kbdsmi	K
Kbdsmr	K
Kbdsmd	K
Kbdsmt	K
Kbdsmm	K
Kbdsmo	K
Di	D
Dr	D
Dd	D
Dt	D
Dm	D
Do	D
Vp	V
Vd	V
L	L
M	M
O	O
N	N